# # # # # # # # # # # # # # # # # # # # # # # # # # # # # # #
# S . . . . . . . . . . . . . . . . . # . . . . . . . . . . #
# # # . # # # # # # # # # # # # # # . # . # # # # # # # # . #
# . . . . . . . . . . . . . . . . . . # . # . . . . . . . . #
# . . # # # # # # # # # # # # # # # # # . # . # # # # # # # #
# . . . . . . . . . . . # # # # # . . # . # . . . . . . . . #
# # # # # # # # # # # . # . . . . . . # . # # # # # # # # . #
# . . . . . . . . . . . # . # # # # # # . # . . # . . . # . #
# . # # # # # # # # # # # . . . . # . # . # . . . . # . . . #
# . # . . . . . . . . . # # # # . # . . . # . # # # # # # # #
# . # . # . # # # # # . # . . . . # . # # # . . . . . # . . #
# . . . # . # . . . . . . . . . . . . # . . . . . . . . . . #
# . . . # . # . . . . . . . . . . . . # . . . . . . . . . . #
# . . . # . # . . . . . . . . . . . . # . . . . . . . . . . #
# . . . # . # . . . . . . . . . . . . # . . . . . . . . . . #
# . . . # . # . . . . . . . . . . . . # . . . . . . . . . . #
# . . . # . # . . . . . . . . . . . . # . . . . . . . . . . #
# . . . # . # . . . . . . . . . . . . # . . . . . . . . . . #
# . . . # . # . . . . . . . . . . . . # . . . . . . F . . . #
# . . . # . # . . . . . . . . . . . . # . . . . . . . . . . #
# . . . # . # . . . . . . . . . . . . # . . . . . . . . . . #
# # # # # # # # # # # # # # # # # # # # # # # # # # # # # # #
